00100100
01011010
01000010
00100100
00011000